1111111111
1P00000001
1000000001
1000000111
10000001C1
1000000111
10000E0001
1111111111