1111111111
1P00000001
1000000001
1000000001
100C000001
1000111001
10001E1001
1111111111