1111111111
1P00000001
1000000001
1000000001
100C000E01
1000000001
10000E0001
1111111111