111111111111111111111111111111
100001000C00000000000000000001
100000011111000000000000000001
1111110000P0000000000000000001
1E0010000010000000000000000001
100010000000000000000000000001
10001000C000000000000000000001
10C000C00000000000000000000001
100000000000000000000000000001
100000000000000000000000000001
100000000000000000000000000001
100000000000000000000000000001
100000000000000000000000000001
100000000000000000000000000001
100000000000000000000000000001
100000000000000000000000000001
100000000000000000000000000001
111111111111111111111111111111