111111111111111111111111111111
100001000C00000000000001000001
1000000111110000000C000100C001
1111110000000000E0000001000001
100010000010000000000000000001
1000100000A000010000000000C001
10001000C000000100000000000001
10C000C00000111111111000000001
100000000000000100000000000001
1000000000000001000000000C0001
100000000000000000000000000001
100000000111111000001000000001
1000000000000000000010000P0001
100000000000000000000000000001
111111111111111111111111111111