11111111111111
100C00P000E001
11111111111111