111111111111111
100001000C00001
100000011111111
1111110000P0001
1E0000000010001
111111111111111