111111111111111
10P0001000C0001
100000000111111
111111000000001
1E0000000010001
111111111111111