

111111111111111111111111111111111
100000000000000000000000000000001
1110001111100C0000000C00000000001
10001000C000000000000000000000001
1P00000000000E0000000000000000001
111111111111111111111111111111111


