111111111
100P01C11
100000011
1001110E1
111111111